111111111111111
110000CC00000E1
10000000C000001
1000000000C0001
100000000000001
1000000000C0001
111111111111111
