111111111111111
1100000000C0001
100000000000001
100000000000001
1000000000P0001
100000000000001
111111111111111
