111111111111111
110000CC10011E1
10000000C000000
1C00000110C0101
1C00000000P0001
1C00C00000C0001
111111111111111
