111111111111111
110000CC00000E1
10000000C0000011
1000000000C00001
1000000000P00011
1000000000C0001
111111111111111
