111111111111110
010000CC10011E1
10000000C000001
1C00000110C0C01
0C00000000P0001
1C00C00000C0001
111111111111111
